xxxxxxxxxxxxxxx
x-------------x
x-x-x-x-x-x-x-x
x-------------x
x-x-x-x-x-x-x-x
x-------------x
x-x-x-x-x-x-x-x
x-------------x
x-x-x-x-x-x-x-x
x-------------x
x-x-x-x-x-x-x-x
x-------------x
xxxxxxxxxxxxxxx
xxxxxxxxxxxxxxx
x-------------x
x-xxxxx-xxxxx-x
x-x---x-x---x-x
x-xxxxx-xxxxx-x
x-------------x
x-xxxxx-xxxxx-x
x-------------x
x-xxxxx-xxxxx-x
x-x---x-x---x-x
x-xxxxx-xxxxx-x
x-------------x
xxxxxxxxxxxxxxx