xxxxxxxxxxxxxxx
x-------------x
x-1-1-1-1-1-1-x
x-------------x
x-1-1-1-1-1-1-x
x-------------x
x-1-1-1-1-1-1-x
x-------------x
x-1-1-1-1-1-1-x
x-------------x
x-1-1-1-1-1-1-x
x-------------x
xxxxxxxxxxxxxxx
xxxxxxxxxxxxxxx
x-------------x
x-11-11-11-11-x
x-1---1-1---1-x
x-11-11-11-11-x
x-------------x
x-11111-11111-x
x-------------x
x-11-11-11-11-x
x-1---1-1---1-x
x-11-11-11-11-x
x-------------x
xxxxxxxxxxxxxxx
xxxxxxxxxxxxxxx
x-------------x
x-1---1-1---1-x
x-1---1-1---1-x
x-1---1-1---1-x
x-------------x
x-11-11-11-11-x
x-------------x
x-1---1-1---1-x
x-1---1-1---1-x
x-1---1-1---1-x
x-------------x
xxxxxxxxxxxxxxx
xxxxxxxxxxxxxxx
x-------------x
x-x---x-x---x-x
x-x---x-x---x-x
x-x---x-x---x-x
x-------------x
x-xx-xx-xx-xx-x
x-------------x
x-x---x-x---x-x
x-x---x-x---x-x
x-x---x-x---x-x
x-------------x
xxxxxxxxxxxxxxx